0,0,0,0,0,0,0,0,0,0,0,0,0
0,0,0,0,0,0,0,0,0,0,0,0,0
0,0,0,0,0,0,0,0,0,0,0,0,0
0,0,0,0,0,0,0,0,0,0,0,0,0
0,0,0,i,0,i,0,i,0,i,0,0,0
0,i,0,0,0,0,0,0,0,0,0,i,0
0,i,i,0,i,0,0,0,i,0,i,i,0
0,0,0,0,0,0,w,0,0,0,0,0,0
0,i,0,0,0,i,o,i,0,0,0,i,0
0,0,0,i,0,0,t,0,0,i,0,0,0
0,0,0,0,0,0,g,0,0,0,0,0,0
0,0,0,i,0,0,r,0,0,i,0,0,0
0,i,0,0,0,i,b,i,0,0,0,i,0
0,0,0,0,0,0,v,0,0,0,0,0,0
0,i,i,0,i,0,0,0,i,0,i,i,0
0,i,0,0,0,0,0,0,0,0,0,i,0
0,0,0,i,0,i,0,i,0,i,0,0,0
0,0,0,0,0,0,0,0,0,0,0,0,0
